abertausend 	abertausend, Abertausend	abertausend, *Abertausend*
Abertausende	Abertausende, abertausende	*Abertausende*, abertausende
abhanden kommen	abhanden kommen	abhandenkommen, abhandengekommen
abscheuerregend	Abscheu erregend	Abscheu erregend, *abscheuerregend*
abseits stehen	abseits stehen	abseitsstehen
abwärts fahren	abwärts fahren	abwärtsfahren
achtfach, 8fach	achtfach, 8fach	achtfach, 8fach, *8-fach*
achtgeben	Acht geben	Acht geben, *achtgeben*, gib Acht, gib *acht*
achthaben	Acht haben	Acht haben, *achthaben*
achtziger Jahre (Jahrzehnt)	Achtzigerjahre, achtziger Jahre (Jahrzehnt)	Achtzigerjahre, *achtziger Jahre* (Jahrzehnt), 80-er Jahre, *80er Jahre*
Achtzigerjahre (Lebensabschnitt)	Achtzigerjahre, achtziger Jahre (Lebensabschnitt)	*Achtzigerjahre*, achtziger Jahre (Lebensabschnitt)
ackerbautreibend	Ackerbau treibend	Ackerbau treibend, *ackerbautreibend*
adieu	Adieu, adieu	*Adieu*, adieu, *Ade*, ade
Agraphie	Agraphie	Agrafie, *Agraphie*, Dysgrafie, *Dysgraphie*
ähnliches	Ähnliches	Ähnliches
ähnlich sehen	ähnlich sehen	ähnlich sehen
alleinerziehend	allein erziehend	allein erziehend, *alleinerziehend*
Alleinerziehende	allein Erziehende, Alleinerziehende	allein Erziehende, *Alleinerziehende*
allein lassen	allein lassen	in wörtlicher Bedeutung allein lassen: Kleinkinder soll man nie allein lassen, in übertragener Bedeutung alleinlassen: sich von aller Welt alleingelassen fühlen 
allein stehen	allein stehen	in wörtlicher Bedeutung allein stehen: das Kleinkind kann schon allein stehen, in übertragener Bedeutung alleinstehen: er gab eine Kontaktanzeige auf, um nicht mehr länger alleinzustehen
alleinstehend	allein stehend	alleinstehend
alleinseligmachend	allein selig machend, alleinseligmachend	allein selig machend, *allein seligmachend*, *selig machen*, seligmachen
alles andere	alles andere	*alles andere*, alles Andere
allgemeinbildend	allgemein bildend	allgemein bildend, *allgemeinbildend*
allgemeingültig	allgemein gültig	allgemein gültig, *allgemeingültig*
Alptraum	Albtraum, Alptraum	Albtraum, *Alptraum*
Alpdruck	Albdruck, Alpdruck	Albdruck, *Alpdruck*
Alpdrücken	Albdrücken, Alpdrücken	Albdrücken, *Alpdrücken* 
alt machen	alt machen	*alt machen*, altmachen
andersdenkend 	anders denkend	anders denkend, *andersdenkend*
Andersdenkende	Andersdenkende, anders Denkende	anders Denkende, *Andersdenkende*
anderslautend	anders lautend	anders lautend, *anderslautend*
anheimfallen	anheim fallen	anheimfallen
anheimstellen	anheim stellen	anheimstellen
angst machen	Angst machen	Angst machen
angst und bange machen	Angst und Bange machen	Angst und Bange machen
angst und bange sein	angst und bange sein	angst und bange sein
anhand, an Hand	anhand	anhand
arbeitsuchend, arbeitssuchend	Arbeit suchend, arbeitssuchend	Arbeit suchend, *arbeitsuchend*, arbeitssuchend
aufeinanderfolgen	aufeinander folgen	aufeinander folgen, *aufeinanderfolgen*, aufeinander folgen, *aufeinanderfolgen* 
aufgrund, auf Grund	aufgrund, auf Grund	*aufgrund*, auf Grund
aufs äußerste	aufs Äußerste	*aufs Äußerste*, aufs äußerste
aufs schlimmste	aufs Schlimmste	*aufs Schlimmste*, aufs schlimmste
aufsehenerregend	Aufsehen erregend	Aufsehen erregend, *aufsehenerregend*
auf seiten	aufseiten, auf Seiten	*aufseiten*, auf Seiten
aufwendig	aufwändig, aufwendig	aufwändig, *aufwendig*
auseinander schreiben	auseinander schreiben	auseinanderschreiben (aber: getrennt schreiben)
auseinandersetzen (sich beschäftigen mit), auseinander setzen (entfernte Sitzplätze zuweisen)	auseinander setzen	auseinandersetzen 
außer acht lassen; das Außerachtlassen	außer Acht lassen; das Außer-Acht-Lassen	außer Acht lassen; das Außerachtlassen


außerstande	außer Stande, außerstande	außer Stande / *außerstande*
bankrott gehen	Bankrott gehen	bankrottgehen; nach der Wirtschaftskrise war die Firma bankrottgegangen; aber: Bankrott machen; bankrott sein 
behende	behände	behände; mit behänden Bewegungen 
beiseite legen	beiseite legen	beiseitelegen; sie hatte sich etwas beiseitegelegt (= etwas gespart); er konnte das Buch kaum beiseitelegen 
bei weitem	bei weitem	bei weitem / bei Weitem; das ist bei weitem / bei Weitem die beste Lösung 
bekanntgeben	bekannt geben	bekannt geben / bekanntgeben; das Unternehmen hatte seinen Börsengang bekannt gegeben / bekanntgegeben 
bekanntmachen (ein Gesetz)   bekannt machen (sich untereinander)	bekannt machen	bekannt machen / bekanntmachen (ein Gesetz)  bekannt machen / bekanntmachen (sich untereinander) 
bereit erklären	bereit erklären	bereit erklären / bereiterklären; die Firma hatte sich spontan bereit erklärt / bereiterklärt, das Geld zu spenden 
bereitmachen (aber: ich habe mich bereit gemacht)	bereitmachen	bereit machen / bereitmachen; er hatte sich bereit gemacht / bereitgemacht; die Reise anzutreten 
besorgniserregend	Besorgnis erregend	Besorgnis erregend / besorgniserregend; ein Besorgnis erregender / besorgniserregender Ausblick; aber nur: ein große Besorgnis erregender Ausblick; ein höchst besorgniserregender Ausblick 
besserverdienend	besser verdienend	besser verdienend / besserverdienend; die besser verdienenden / besserverdienenden Angestellten; die Steuerreform nützt nur den besser Verdienenden / Besserverdienenden; aber: die gut verdienenden / gutverdienenden Beamten 
bewußtmachen (klarmachen)    bewußt machen (absichtlich machen)	bewusst machen	bewusst machen / bewusstmachen (klarmachen); er war gezwungen, sich den Ernst der Lage bewusst zu machen / bewusstzumachen  bewusst machen (absichtlich machen); er hatte den Fehler bewusst gemacht 
Bibliographie	Bibliographie / Bibliografie	Bibliographie / Bibliografie (Bücherverzeichnis); der Autor konnte auf eine umfassende Bibliographie / Bibliografie zurückblicken; die bibliographische / bibliografische Erfassung seiner Werke; aber: Lexikographie / Lexikografie (Lehre von der Abfassung von Wörterbüchern) 
Biographie	Biographie / Biografie	Biographie / Biografie (Lebenslauf, -geschichte); eine bunt schillernde Biographie / Biografie; die biographischen / biografischen Daten; entsprechend: Selbstbiographie / Selbstbiografie; Monographie / Monografie; Autobiographie / Autobiografie; aber: das Autograph / Autograf (eigenhändig geschriebenes Schriftstück einer bekannten Persönlichkeit) 
bis auf weiteres	bis auf weiteres	bis auf weiteres / bis auf Weiteres; es bleibt bis auf weiteres / bis auf Weiteres alles beim Alten 
bißchen	bisschen	bisschen; darf es ein bisschen mehr sein? 
Blackout	Black-out / Blackout	Black-out / Blackout; der Redner hatte einen Black-out / Blackout, er hatte seinen Text komplett vergessen; entsprechend: Fall-out / Fallout (radioaktiver Niederschlag); Hand-out / Handout (zu verteilendes Infomaterial); Knock-out / Knockout (K. o.); Lay-out / Layout; vgl. aber: Buy-out / Buyout 
blauer Brief	blauer Brief	Blauer Brief / blauer Brief; sie hatte als Einzige in der Klasse einen Blauen Brief / blauen Brief erhalten 
(nicht verzeichnet)	Blinddate / Blind Date	Blind Date (Verabredung mit jmdm., den man nicht kennt) 
bloßlegen	bloßlegen	in wörtlicher Bedeutung bloß legen / bloßlegen: bei der Renovierung wurden alle Rohre bloß gelegt / bloßgelegt  in übertragener Bedeutung bloßlegen: er fühlte sich bestrebt, sein Innerstes bloßzulegen 
bloßstrampeln	bloßstrampeln	bloß strampeln; das Baby hatte sich bloß gestrampelt 
breitgefächert	breit gefächert	breit gefächert / breitgefächert; ein breit gefächertes / breitgefächertes Angebot; aber: das Angebot ist breit gefächert / breitgefächert 
Brennessel	Brennnessel	Brennnessel / Brenn-Nessel; aus Brennnesseln / Brenn-Nesseln lassen sich schmackhafte Gerichte wie Brennnesselsalat oder Brennnesselsuppe machen 
brustschwimmen	brustschwimmen	brustschwimmen / Brust schwimmen; er war zwei Bahnen brustgeschwommen / Brust geschwommen; aber nur: sie schwimmt Brust 
buchführend	Buch führend / buchführend	Buch führend / buchführend; die Buch führende / buchführende Geschäftsstelle; aber nur: er pflegte über alle seine Ausgaben Buch zu führen 
Buyout	Buy-out	Buy-out / Buyout (kurz für: Management-Buy-out / Management-Buyout = Übernahme eines Unternehmens durch das eigene Management); entsprechend: Burn-out / Burnout (kurz für: Burn-out-Syndrom / Burnoutsyndrom); Coming-out / Comingout; Work-out / Workout (Fitnesstraining); vgl. aber: Black-out / Blackout 
Café au lait	Café au Lait	Café au Lait (Milchkaffee); aber: Café complet; Café crème; Caffè Latte 
(nicht verzeichnet)	Callcenter / Call-Center	Callcenter / Call-Center; im Bereich der Kundenpflege werden immer häufiger Callcenter / Call-Center eingesetzt 
Cash-flow	Cashflow / Cash-Flow	Cashflow (Überschuss eines Unternehmens nach Abzug der Ausgaben als wirtschaftliche Kennziffer) 
Chansonnier   Chansonnière   Chansonnette / Chansonette	Chansonnier / Chansonier   Chansonnière / Chansoniere   Chansonnette / Chansonette	Chansonnier / Chansonier (Chansonsänger)  Chansonnière / Chansoniere (Chansonsängerin)  Chansonnette / Chansonette (Chansonsängerin; kleines Chanson) 
Chicorée	Chicorée / Schikoree	Chicorée / Schikoree (die weißen Blätter der Salatzichorie) 
Compact Disc	Compactdisc	Compact Disc / Compact Disk 
Creme / Krem	Creme / Krem / Kreme	Creme / Krem / Kreme; eine Karamellcreme / Karamellkrem / Karamellkreme; aber: Crème Caramel 
Crêpe (franz. Pfannkuchen)   Crêpe / Krepp (krauses Gewebe)	Crêpe / Krepp (franz. Pfannkuchen)   Crêpe / Krepp (krauses Gewebe)	Crêpe / Krepp (franz. Pfannkuchen); Crêpes mit Amaretto  Crêpe / Krepp (krauses Gewebe); Crêpe de Chine 
Curriculum vitae	Curriculum Vitae	Curriculum Vitae (Lebenslauf); in der Anlage finden Sie mein Curriculum Vitae 
dafürkönnen	dafürkönnen / dafür können	dafürkönnen; es war klar, dass er nichts dafürkonnte; sie behauptete, nichts dafürzukönnen; aber: sie behauptete, dafür nichts zu können; sie behauptete, nichts dafür (= für diesen Fehler) zu können 
dagewesen	da gewesen	da gewesen / dagewesen; eine noch nie da gewesene / dagewesene Begeisterung; etwas noch nie da Gewesenes / Dagewesenes; aber nur: alles ist schon einmal da gewesen 
dahin gehend	dahin gehend	dahin gehend / dahingehend; seine dahin gehenden / dahingehenden Äußerungen; die Arbeit lässt sich dahin gehend / dahingehend interpretieren 
danke	danke	danke / Danke; bekommt man etwas geschenkt, sollte man immer danke / Danke sagen; dafür möchte ich dir herzlich danke schön / Danke schön sagen; aber nur: aber: dafür möchte ich dir ein herzliches Dankeschön sagen; und nur: er sagt Dank 
daß	dass	dass; es ist bekannt, dass Dasssätze / dass-Sätze manchen Probleme bereiten 
datenverarbeitend	Daten verarbeitend	Daten verarbeitend / datenverarbeitend; ein Daten verarbeitendes / datenverarbeitendes Gerät; die Daten verarbeitende / datenverarbeitende Stelle 
Dekolleté / Décolleté	Dekolletee / Dekolleté	Dekolletee / Dekolleté (Ausschnitt); ihr Dekolletee / Dekolleté ließ tief blicken 
Delphin	Delfin / Delphin	Delfin / Delphin; Delfine / Delphine hält man im Delfinarium / Delphinarium 
delphinschwimmen	delfinschwimmen / delphinschwimmen	Delfin schwimmen / Delphin schwimmen / delfinschwimmen / delphinschwimmen; aber nur: er schwimmt Delfin / Delphin 
deplaziert / deplaciert	deplatziert / deplaciert	deplatziert / deplaciert; eine deplatzierte / deplacierte (unangebrachte) Bemerkung 
des öfteren	des Öfteren	des Öfteren; sie war schon des Öfteren zu spät gekommen 
des weiteren	des Weiteren	des Weiteren; es wurde des Weiteren vermeldet ... 
dichtbevölkert	dicht bevölkert	dicht bevölkert / dichtbevölkert; ein dicht bevölkertes / dichtbevölkertes Land; aber nur: Das Land ist dicht bevölkert. 
dichtmachen (schließen; zumachen)      dicht machen (abdichten)	dichtmachen (schließen; zumachen)      dicht machen (abdichten)	dichtmachen (schließen; zumachen); nach dem Skandal hatte die Firma dichtgemacht; die Läden machen heute erst um 22 Uhr dicht; du musst bei diesem Thema nicht gleich dichtmachen!  dicht machen / dichtmachen (abdichten); die Schotten dicht machen / dichtmachen; in der Werkstatt wurde das Cabrioverdeck wieder dicht gemacht / dichtgemacht 
Dienstag abend	Dienstagabend	Dienstagabend 
Dienstag abends / dienstags abends	dienstagabends / dienstags abends	dienstagabends / dienstags abends 
diensthabend	Dienst habend	Dienst habend / diensthabend; zuständig ist die Dienst habende / diensthabende Aufsicht; aber nur: der/die Diensthabende; entsprechend: Dienst leistend / dienstleistend; Dienst tuend / diensttuend 
Direct-Mailing	Directmailing /  Direct Mailing	Direct Mailing; mit einem gezielten Direct Mailing neue Kunden gewinnen 
Donnerstag abend	Donnerstagabend	Donnerstagabend 
Donnerstag abends / donnerstags abends	donnerstagabends / donnerstags abends	donnerstagabends / donnerstags abends 
Dönerkebab / Döner Kebab	Dönerkebab / Döner Kebab	Dönerkebab / Döner Kebab; in türkischer Schreibung: Dönerkebap / Döner Kebap; kurz: Döner; an dieser Dönerbude gibt es den besten Dönerkebab / Döner Kebab der Stadt 
doppelt gemoppelt	doppelt gemoppelt	doppelt gemoppelt / doppeltgemoppelt (ugs. unnötigerweise zweifach vorhanden) 
doppeltwirkend	doppelt wirkend	doppelt wirkend / doppeltwirkend; ein doppelt wirkender / doppeltwirkender Hydraulikzylinder (Technik), ein doppelt wirkendes / doppeltwirkendes Mittel (Medizin) 
dumm kommen	dumm kommen	dumm kommen / dummkommen; willst du mir jetzt dumm kommen / dummkommen? 
dünnbesiedelt	dünn besiedelt	dünn besiedelt / dünnbesiedelt; ein dünn besiedelter / dünnbesiedelter Landstrich; entsprechend: dünn bevölkert / dünnbevölkert 
dünn gesät	dünn gesät	dünn gesät / dünngesät; Fachleute sind in diesem Bereich dünn gesät / dünngesät; aber nur: spärlich gesät 
durcheinanderbringen	durcheinander bringen	durcheinanderbringen; im Bericht wurde einiges durcheinandergebracht 
durcheinanderreden	durcheinander reden	durcheinanderreden; der Diskussionsleiter bat die Teilnehmer, nicht durcheinanderzureden 
ebensoviel; ebenso viele	ebenso viel; ebenso viele	ebenso viel; ebenso viele; das Kino hat ebenso viel gekostet wie die Snacks; an der Straße standen ebenso viele Laternen wie Bäume; aber: ebensovielmal / ebenso viel Mal 
ehrfurchtgebietend	Ehrfurcht gebietend	Ehrfurcht gebietend / ehrfurchtgebietend; ein Ehrfurcht gebietender / ehrfurchtgebietender Anblick; aber nur: ein größte Ehrfurcht gebietender Anblick; ein äußerst ehrfurchtgebietender Anblick 
einbläuen (etwas blau färben)  einbleuen (jdm. etwas einprägen)	einbläuen (etwas blau färben; jdm. etwas einprägen)	einbläuen (etwas blau färben;  jdm. etwas einprägen) 
eine Zeitlang	eine Zeit lang	eine Zeit lang / eine Zeitlang; sie möchte eine Zeit lang / eine Zeitlang ausspannen; aber nur: einige Zeit lang; eine kurze Zeit lang 
einigemal; einige Male	einige Mal; einige Male	einige Mal; einige Male; das habe ich dir schon einige Mal gesagt! 
einiggehen	einig gehen	einiggehen; in diesen Punkten gehen wir einig; sie waren in allen Fragen einiggegangen 
Einmarkstück	Einmarkstück; Eineurostück	Einmarkstück; Eineurostück / Ein-Euro-Stück; aber nur:  1-Euro-Stück 
Einsteinsche Gleichung	einsteinsche / Einstein'sche Gleichung	einsteinsche / Einstein'sche Gleichung 
ein und alles	Ein und Alles	Ein und Alles; du bist mein Ein und Alles! 
einzelnstehend	einzeln stehend	einzeln stehend / einzelnstehend; eine einzeln stehende / einzelnstehende Eiche 
einzelne	Einzelne	Einzelne; alles bis ins Einzelne klären; der Einzelne in der Menge; jeder Einzelne ist verantwortlich; vom Einzelnen zum Gesamten 
eisenverarbeitend	Eisen verarbeitend	Eisen verarbeitend / eisenverarbeitend; die Eisen verarbeitende / eisenverarbeitende Industrie 
eisigkalt	eisig kalt	eisig kalt; ein eisig kalter Winter; die Nacht war eisig kalt 
eislaufen	Eis laufen	eislaufen; er läuft eis, im Urlaub sind wir Ski und eisgelaufen / eis- und Ski gelaufen 
(nicht verzeichnet)	emailen / e-mailen	emailen / e-mailen; sie emailten / e-mailten hin und her; aber nur: er hatte die Nachricht geemailt 
energiesparend	energiesparend / Energie sparend	energiesparend / Energie sparend; eine energiesparende / Energie sparende Lösung; aber nur: eine sehr energiesparende Lösung 
ernstgemeint;  aber: die Frage ist ernst gemeint	ernst gemeint	ernst gemeint / ernstgemeint; eine ernst gemeinte / ernst gemeinte Empfehlung; aber nur: das war doch nicht ernst gemeint! 
ernstzunehmend / ernst zu nehmend	ernst zu nehmend / ernstzunehmend	ernst zu nehmend / ernstzunehmend; ein ernst zu nehmender / ernstzunehmender Einwand; aber: den Einwand ernst nehmen 
Erste Hilfe	erste Hilfe	erste Hilfe / Erste Hilfe; einen Kurs in erster Hilfe / Erster Hilfe belegen 
essentiell	essenziell / essentiell	essenziell / essentiell; die essenziellen / essentiellen Voraussetzungen 
fallen lassen (zu Boden)     fallenlassen (z. B. eine Idee)	fallen lassen	fallen lassen (zu Boden); er hatte die Vase fallen lassen; auch: er hatte die Maske fallen lassen und zeigte nun sein wahres Gesicht  fallenlassen / fallen lassen (z. B. eine Idee); sie musste ihren Plan wieder fallenlassen / fallen lassen; die Eltern hatten ihren Sohn fallenlassen / fallen lassen (aufgehört, ihn zu unterstützen) 
Fast food	Fastfood / Fast Food	Fastfood / Fast Food; diese Fastfoodkette / Fast-Food-Kette ist in allen Ländern vertreten; ein schnelles Essen im Fastfoodrestaurant / Fast-Food-Restaurant 
feind (jemandem feind sein)	Feind (jemandem Feind sein)	feind (jemandem Feind sein); sie war ihm feind; dieser Sache bin ich feind 
fertigstellen	fertig stellen	fertig stellen / fertigstellen; das in Windeseile fertig gestellte / fertiggestellte Haus 
fertig werden	fertig werden	fertig werden / fertigwerden (zum Ende bringen); sie glaubte, mit der Arbeit bis zum Abend fertig zu werden / fertigzuwerden (sie bis dahin zu beenden)  fertig werden / fertigwerden (bewältigen); sie glaubte, mit dieser Arbeit fertig zu werden / fertigzuwerden (sie zu meistern) 
fischverarbeitend	Fisch verarbeitend	Fisch verarbeitend / fischverarbeitend; die Fisch verarbeitende / fischverarbeitende Industrie 
Fitneß	Fitness	Fitness; im Fitnessstudio / Fitness-Studio waren erfahrene Fitnesstrainer beschäftigt 
Flußschiffahrt	Flussschifffahrt	Flussschifffahrt /  Fluss-Schifffahrt; in der Schifffahrt / Schiff-Fahrt unterscheidet man zwischen Flussschifffahrt / Fluss-Schifffahrt und Seeschifffahrt / Seeschiff-Fahrt 
Fön (Haartrockner)   Föhn (warmer Fallwind)	Föhn; nur als eingetr. Warenzeichen: Fön (Haartrockner)  Föhn (warmer Fallwind)	Föhn; nur als eingetr. Warenzeichen: Fön (Haartrockner)  Föhn (warmer Fallwind) 
fönen	föhnen	föhnen;  sich die Haare föhnen 
Fotografie / Photographie	Fotografie / Photographie	Fotografie / Photographie; eine Ausstellung mit Fotografien / Photographien; er fotografierte / photographierte alles, was ihm vor die Linse kam; entsprechend: Klecksografie / Klecksographie (Tintenklecksbild für psychologische Auswertung); aber: Fonografie / Phonographie (Verzeichnis von Tonaufnahmen) 
freilaufend	frei laufend	frei laufend / freilaufend; die Eier sind von frei laufenden / freilaufenden (nicht in Käfigen gehaltenen) Hühnern; entsprechend: frei lebende / freilebende (in freier Natur lebende) Enten und Gänse 
Freitag abend	Freitagabend	Freitagabend 
Freitag abends / freitags abends	freitagabends / freitags abends	freitagabends / freitags abends 
Freudsche Fehlleistung	freudsche Fehlleistung / Freud'sche Fehlleistung	freudsche Fehlleistung / Freud'sche Fehlleistung (auch: freudscher Versprecher / Freud'scher Versprecher; Versprecher, bei dem angeblich das eigentlich Gemeinte deutlich wird) 
freund (jemandem freund sein)	Freund (jemandem Freund sein)	freund (jemandem freund sein); sie war ihm freund 
frischgebacken	frisch gebacken	in wörtlicher Bedeutung frisch gebacken / frischgebacken; frisch gebackene / frischgebackene Brötchen  in übertragener Bedeutung frischgebacken; das frischgebackene Ehepaar 
Friseur / Frisör	Friseur / Frisör	Friseur / Frisör; im Friseursalon / Frisörsalon waren viele Friseure / Frisöre und Friseurinnen (ugs. auch: Friseusen) / Frisörinnen (ugs. auch: Frisösen) beschäftigt 
fritieren; Friteuse	frittieren; Fritteuse	frittieren; Fritteuse; sie frittierte die Fritten in der Fritteuse; aber: Pommes frites 
furchterregend	Furcht erregend	Furcht erregend / furchterregend; unter den Dinosauriern gab es Furcht erregende / furchterregende Exemplare; aber nur: große Furcht erregend; äußerst furchterregend; noch furchterregender; entsprechend: Furcht einflößend / furchteinflößend 
fürliebnehmen	fürlieb nehmen	fürliebnehmen; mit einem Gebrauchtwagen fürliebnehmen; der Verkäufer bat, mit einem Gutschein fürliebzunehmen 
Gams; Gemse	Gams; Gämse	Gams; Gämse; die Gämsen sind wahre Kletterkünstler 
gar kochen; gargekocht	gar kochen; gar gekocht	gar kochen / garkochen; gar gekocht / gargekocht; das gar gekochte / gargekochte Fleisch; aber: Das Fleisch ist gar gekocht / gargekocht 
genaugenommen	genau genommen	genau genommen / genaugenommen; genau genommen / genaugenommen sind Delfine gar keine Fische; eine genau genommene / genaugenommene Anweisung; aber nur: er hat es mit den Finanzen stets sehr genau genommen 
Geographie	Geographie / Geografie	Geographie / Geografie; der neue Geographielehrer / Geografielehrer ist sehr bewandert; die Biogeographie / Biogeografie beschreibt die geographische / geografische Verbreitung der Tiere und Pflanzen; aber: Hydrographie / Hydrografie (Gewässerkunde); Ozeanographie / Ozeanografie (Meereskunde) 
gerngesehen	gern gesehen	gern gesehen / gerngesehen; er war ein gern gesehener / gerngesehener  (= willkommener) Gast; aber: die gern gesehene / gerngesehene (= gern angeschaute) Fernsehsendung; aber nur: er war bei uns gern gesehen; er gehörte zu den gerngesehensten (besser: am liebsten gesehenen) Gästen 
gern haben	gern haben	gernhaben; sie sagt, dass sie ihn gernhat; aber: dieses Wörterbuch möchte ich gern haben 
Geschoß	Geschoss  (südd./österr.: Geschoß)	Geschoss  (südd./österr.: Geschoß); aus der Waffe löste sich ein Geschoss (südd./österr.: Geschoß); sie wohnte im Erdgeschoss (südd./österr.: Erdgeschoß) 
gestern abend	gestern Abend	gestern Abend; es war gestern Abend sehr nett bei euch; entsprechend: heute Abend; morgen Abend; aber: gestern früh / gestern Früh 
Getto / Ghetto	Getto / Ghetto	Getto / Ghetto; Gettoisierung / Ghettoisierung; Gettoblaster / Ghettoblaster 
glatthobeln	glatt hobeln	glatt hobeln / glatthobeln; er hatte die Platte mit einer Raubank glatt gehobelt / glattgehobelt; entspr.: glatt bügeln / glattbügeln; glatt rasieren / glattrasieren; glatt rühren / glattrühren; aber Zusammenschreibung bei übertragener Bedeutung: eine Rechnung glattmachen (bezahlen); das ist noch einmal glattgegangen! 
gleichbleibend	gleich bleibend	gleich bleibend / gleichbleibend; Fertigung in gleich bleibender / gleichbleibender Qualität 
Glimmstengel	Glimmstängel	Glimmstängel (= Zigarette); er kann von den Glimmstängeln nicht lassen 
glühendheiß	glühend heiß	glühend heiß; auf der glühend heißen Herdplatte kochte das Wasser im Nu. 
Graphik / Grafik	Graphik / Grafik	Graphik / Grafik; die Graphiker / Grafiker aus der Graphikabteilung / Grafikabteilung; eine teure Graphikkarte / Grafikkarte 
gräulich; graulich (graufarben)  greulich (grauenerregend)	gräulich; graulich (graufarben)  gräulich (grauenerregend)	gräulich; graulich (graufarben)  gräulich (grauenerregend) 
Greuel	Gräuel	Gräuel; Knäuel in der Leitung sind Technikern ein Gräuel; sie las gerne Gräuelmärchen 
großschreiben (hochhalten, besonders schätzen)      groß schreiben (mit großem Anfangsbuchstaben schreiben; in großer Schrift schreiben)	großschreiben (mit großem Anfangsbuchstaben schreiben)      groß schreiben (hochhalten, besonders schätzen; in großer Schrift schreiben)	großschreiben (mit großem Anfangsbuchstaben schreiben; hochhalten, besonders schätzen); Mitverantwortung wird hier großgeschrieben; aber:  Mitverantwortung wird hier ganz groß geschrieben  groß schreiben (in großer Schrift schreiben) 
guttun	gut tun	guttun; der Urlaub hatte ihr gutgetan; die Massage wird dir guttun! 
händchenhaltend	Händchen haltend	Händchen haltend / händchenhaltend; frisch verliebt und Händchen haltend / händchenhaltend liefen sie durch den Park 
hängenbleiben (in der Schule; im Gedächtnis)        hängen bleiben (Gemälde an der Wand)	hängen bleiben	hängen bleiben / hängenbleiben (in der Schule; im Gedächtnis); er drohte zum zweiten Mal hängen zu bleiben / hängenzubleiben; sie ist mit ihrem Mantel an einem hervorstehenden Haken hängen geblieben / hängengeblieben; der Vortrag war so langweilig, dass nichts hängen blieb / hängenblieb  hängen bleiben (Gemälde an der Wand); die Bilder der Ausstellung sollen noch bis zum Winter hängen bleiben 
Happy-End; österr. auch: Happyend	Happyend / Happy End	Happyend / Happy End; im Leben gibt es leider nicht immer ein Happyend / Happy End 
Hard cover  Hard-cover-Einband	Hardcover / Hard Cover  Hardcovereinband / Hard-Cover-Einband	Hardcover  Hardcovereinband / Hardcover-Einband  
heißgeliebt	heiß geliebt	heiß geliebt / heißgeliebt; er musste sein heiß geliebtes / heißgeliebtes Motorrad verkaufen; entsprechend:  heiß begehrt / heißbegehrt;  heiß ersehnt / heißersehnt;  heiß umkämpft / heißumkämpft;  heiß umstritten / heißumstritten 
heißlaufen	heißlaufen	heiß laufen; der Motor hatte sich heiß gelaufen; aber: der heiß gelaufene / heißgelaufene Motor 
heiß machen	heiß machen	in wörtlicher Bedeutung heiß machen / heißmachen; sie beschloss, sich auf die Schnelle Ravioli heiß zu machen / heißzumachen  in übertragener Bedeutung heißmachen; die Hölle heißmachen; das kann mich nicht heißmachen (beunruhigen); sie hatte ihn ganz heißgemacht (sexuell angeregt) 
heute nachmittag	heute Nachmittag	heute Nachmittag; für heute Nachmittag wurden Gewitter angekündigt; entsprechend: gestern Nachmittag; morgen Nachmittag; aber: heute früh / heute Früh 
hierzulande	hierzulande / hier zu Lande	hierzulande / hier zu Lande; das ist nicht nur hierzulande / hier zu Lande so üblich; entsprechend: dort zu Lande / dortzulande 
hochgesteckt	hoch gesteckt	hochgesteckt; die hochgesteckten Haare standen ihr gut; sie hatte hochgesteckte Ziele 
hochkomplex	hoch komplex	hochkomplex; das sind hochkomplexe Zusammenhänge; aber: hoch kompliziert / hochkompliziert 
hochkonzentriert	hochkonzentriert; die hochkonzentrierten Schüler; aber: eine hoch konzentrierte / hochkonzentrierte Säure	hoch konzentriert / hochkonzentriert; die hoch konzentrierten / hochkonzentrierten Schüler; aber nur: eine hochkonzentrierte Säure 
hochqualifiziert	hoch qualifiziert	hoch qualifiziert / hochqualifiziert; in dieser Branche sind hoch qualifizierte / hochqualifizierte Fachkräfte schwer zu finden; entspr.: hoch begabt / hochbegabt; hoch bezahlt / hochbezahlt; hoch dotiert / hochdotiert; hoch spezialisiert / hochspezialisiert 
hohnlachen	hohnlachen / Hohn lachen	hohnlachen / Hohn lachen; sie hohnlachte ihm / lachte ihm Hohn; sie hatte ihm hohngelacht / Hohn gelacht; aber nur: sie neigte dazu, ihm Hohn zu lachen 
hohnsprechen	hohnsprechen / Hohn sprechen	hohnsprechen / Hohn sprechen; ein den gültigen Gesetzen hohnsprechendes / Hohn sprechendes Urteil; das Urteil, das den gültigen Gesetzen hohnsprach / Hohn sprach; aber: das Urteil hohnsprach den gültigen Gesetzen / sprach den gültigen Gesetzen Hohn; aber nur: das Urteil schien den gültigen Gesetzen Hohn zu sprechen 
holzverarbeitend	Holz verarbeitend	Holz verarbeitend / holzverarbeitend; die Holz verarbeitende / holzverarbeitende Industrie 
Homedreß	Homedress / Home-Dress	Homedress / Home-Dress; sie empfing die Gäste im Homedress / Home-Dress 
Hungers sterben	hungers sterben	hungers sterben; aber: vor Hunger sterben 
im allgemeinen	im Allgemeinen	im Allgemeinen; der Sommer bringt im Allgemeinen warme Temperaturen 
im besonderen	im Besonderen	im Besonderen; er war an bildender Kunst, im Besonderen an Malerei, interessiert 
Imbiß	Imbiss	Imbiss; er holte sich am Imbissstand / Imbiss-Stand schnell noch einen Imbiss 
im folgenden (weiter unten)  im Folgenden (in den folgenden Ausführungen)	im Folgenden	im Folgenden 
im großen und ganzen	im Großen und Ganzen	im Großen und Ganzen; der Abend konnte im Großen und Ganzen als gelungen bezeichnet werden 
im klaren	im Klaren	im Klaren; er war sich über die Konsequenzen im Klaren 
immerwährend	immer während	immer während / immerwährend; ein immer währender / immerwährender Kalender 
im nachhinein	im Nachhinein	im Nachhinein; im Nachhinein tat ihm die Sache leid; aber: von vornherein 
im übrigen	im Übrigen	im Übrigen; ich bin im Übrigen (ferner) der Meinung, dass ...; auch: das Übrige; alles Übrige; alle Übrigen 
imstande	imstande / im Stande	imstande / im Stande (süddt. auch: imstand / im Stand); imstande / im Stande sein, sie fühlte sich nicht imstande / im Stande, ihm zu helfen 
im voraus	im Voraus	im Voraus; bei Bestellungen müssen Sie im Voraus bezahlen; vielen Dank im Voraus! 
im wesentlichen	im Wesentlichen	im Wesentlichen; im Wesentlichen hast du recht! 
in acht nehmen	in Acht nehmen	in Acht nehmen; nimm dich bloß in Acht! 
in bezug auf	in Bezug auf	in Bezug auf; in Bezug auf Ihr Schreiben vom ... 
in Frage	infrage / in Frage	infrage / in Frage; die infrage / in Frage kommenden Lösungen; das steht noch infrage / in Frage; musst du immer alles infrage / in Frage stellen? 
irgend etwas	irgendetwas	irgendetwas; es lag irgendetwas in der Luft, was beunruhigend war 
irgend jemand	irgendjemand	irgendjemand; sie sprach mit irgendjemand Unbekanntem; kann mir irgendjemand helfen? 
Joghurt	Joghurt / Jogurt	Joghurt / Jogurt; der Joghurt / Jogurt im Joghurtbecher / Jogurtbecher 
Joint-venture	Joint Venture / Jointventure	Joint Venture; die beiden Firmen bildeten ein Joint Venture 
jung und alt	Jung und Alt	Jung und Alt; ein Straßenfest für Jung und Alt (= für jedermann) 
jungverheiratet (vor kurzem)   jung verheiratet (in jungen Jahren)	jungverheiratet (vor kurzem)   jung verheiratet (in jungen Jahren)	jungverheiratet (vor kurzem); das jungverheiratete Paar fuhr in die Flitterwochen  jung verheiratet / jungverheiratet (in jungen Jahren); das jung verheiratete / jungverheiratete Paar feierte goldene Hochzeit 
Kaki / Khaki	Kaki / Khaki	Kaki / Khaki (Farbbezeichnung und Bezeichnung des Leinenstoffs dieser Farbe); die Pfadfinder trugen Uniformen aus Kaki / Khaki; ein kakifarbenes / khakifarbenes Hemd; aber: Kakibaum; Kaki (Frucht) 
kalt stellen (Getränke)  kaltstellen (einen Rivalen)	kalt stellen (Getränke)  kaltstellen (einen Rivalen)	kalt stellen / kaltstellen (Getränke)  kaltstellen (einen Rivalen) 
kaltgepresst	kalt gepresst	kalt gepresst / kaltgepresst; hochwertiges Olivenöl wird kalt gepresst / kaltgepresst; entsprechend: kalt geschleuderter / kaltgeschleuderter Honig 
kaltlächelnd	kalt lächelnd	kalt lächelnd / kaltlächelnd; er schmiss uns kalt lächelnd / kaltlächelnd raus 
Känguruh	Känguru	Känguru; im Zoo waren ein Gnu und ein Känguru zu sehen 
kennenlernen	kennen lernen	kennen lernen / kennenlernen; sie hatte einen netten Mann kennen gelernt / kennengelernt; um Natur und Land kennen zu lernen / kennenzulernen und lieben zu lernen; Substantivierung: Partys machen das Kennenlernen leicht 
Ketchup / Catchup	Ketchup / Ketschup	Ketchup / Ketschup; Pommes frites mit Tomatenketchup / Tomatenketschup 
klarwerden	klar werden	In wörtlicher Bedeutung klar werden: Das Wetter ist klar geworden.  In übertragener Bedeutung klar werden / klarwerden: Mir ist Verschiedenes klar geworden / klargeworden. 
klasse (das ist klasse!)	Klasse (das ist Klasse!)	klasse (das ist klasse!); ein klasse Vorschlag; das Konzert war klasse; aber: das hat Klasse; das ist große Klasse 
Kleingedruckte	klein Gedruckte / Kleingedruckte	klein Gedruckte / Kleingedruckte; oft übersieht man in Verträgen das klein Gedruckte / Kleingedruckte 
kleinhacken	klein hacken	klein hacken / kleinhacken; die Zwiebeln klein hacken / kleinhacken; aber: klein gehackte / kleingehackte Zwiebeln; aber nur: kleiner hacken; äußerst klein hacken; sehr klein gehackt; entsprechend: klein mahlen / kleinmahlen 
kleinkariert	kleinkariert (kleinlich; spießig)   klein kariert (mit kleinen Karos)	kleinkariert (kleinlich; spießig); er ist der kleinkarierteste Mensch, den ich kenne  klein kariert / kleinkariert (mit kleinen Karos); ein klein kariertes / kleinkariertes Hemd 
kleinschneiden	klein schneiden	klein schneiden / kleinschneiden; die Tomaten klein schneiden / kleinschneiden; aber: klein geschnittene / kleingeschnittene Tomaten; aber nur: kleiner schneiden; äußerst klein schneiden; sehr klein geschnitten; ebenfalls nur: klein würfeln 
kleinschreiben (nicht so wichtig nehmen)   klein schreiben (mit kleinem Anfangsbuchstaben schreiben; in kleiner Schrift schreiben)	kleinschreiben (mit kleinem Anfangsbuchstaben schreiben)  klein schreiben (nicht so wichtig nehmen; in kleiner Schrift schreiben)	kleinschreiben (mit kleinem Anfangsbuchstaben schreiben; nicht so wichtig nehmen)  klein schreiben (in kleiner Schrift schreiben) 
Know-how	Know-how	Know-how / Knowhow; ein Experte mit viel Know-how / Knowhow; die beiden Unternehmen vereinbarten einen Know-how-Transfer / Knowhowtransfer 
kommen lassen	kommen lassen	In wörtlicher Bedeutung kommen lassen: Er fühlte sich nicht wohl und musste einen Arzt kommen lassen.  In übertragener Bedeutung kommen lassen / kommenlassen: Zur Strategie gehörte, den Gegner erst kommen zu lassen / kommenzulassen. Du musst die Kupplung langsam kommen lassen / kommenlassen! 
konform gehen	konform gehen	konformgehen; in dieser Frage gehe ich mit dir konform; hier sollten wir konformgehen 
kopfstehen	Kopf stehen	kopfstehen; die Welt stand kopf; er versuchte 10 Minuten lang kopfzustehen; aber: auf dem Kopf stehen 
kostensparend	Kosten sparend	Kosten sparend / kostensparend; das neue Heizsystem arbeitet Energie und Kosten sparend / energie- und kostensparend; aber nur: ein höchst kostensparendes Heizsystem; das kostensparendste Heizsystem; entspr.: Kosten senkend / kostensenkend; Kosten deckend / kostendeckend 
kraftraubend	Kraft raubend / kraftraubend	Kraft raubend / kraftraubend; die Expedition war ein Kraft raubendes / kraftraubendes Unterfangen; aber nur: sehr viel Kraft raubend; äußerst kraftraubend; entsprechend:  Kraft sparend / kraftsparend;  Kräfte schonend / kräfteschonend;  Kräfte sparend / kräftesparend;  Kräfte raubend / kräfteraubend 
krankmachen	krankmachen	krankmachen (krankfeiern); sie hatte am Montag krankgemacht; aber: der Lärm hatte sie ganz krankgemacht / krank gemacht 
krank schreiben	krankschreiben	krankschreiben; der Arzt entschied, sie krankzuschreiben; er war für zwei Wochen krankgeschrieben; entsprechend: gesundschreiben; gesundgeschrieben 
krebserregend	Krebs erregend / krebserregend	Krebs erregend / krebserregend; aber nur: ein äußerst krebserregendes Mittel 
kriegführend	Krieg führend	Krieg führend / kriegführend; die Krieg führenden / kriegführenden Länder; entsprechend: die nicht Krieg führenden / nichtkriegführenden Parteien 
kurz fassen	kurz fassen	kurzfassen; ich werde versuchen, mich kurzzufassen; aber: ein kurzgefasster / kurz gefasster Bericht; ich habe den Bericht kurzgefasst / kurz gefasst 
langanhaltend	lang anhaltend	lang anhaltend / langanhaltend; lang anhaltender / langanhaltender Applaus; lang anhaltende / langanhaltende Regenfälle 
langgehegt	lang gehegt	lang gehegt / langgehegt; ein lang gehegter / langgehegter Wunsch ging in Erfüllung 
längsgestreift	längs gestreift / längsgestreift	längs gestreift / längsgestreift; eine längs gestreifte / längsgestreifte Markise 
lederverarbeitend	Leder verarbeitend	Leder verarbeitend / lederverarbeitend; die Leder verarbeitende / lederverarbeitende Industrie 
leer essen	leer essen	leer essen / leeressen; die Kinder hatten die Teller begeistert leer gegessen / leergegessen; entsprechend: leer trinken / leertrinken 
leerstehend	leer stehend	leer stehend / leerstehend; in dieser Gegend gibt es viele leer stehende / leerstehende Wohnungen; aber nur: wir haben festgestellt, dass hier viele Wohnungen leer stehen 
leid tun	Leid tun	leidtun; es tut mir leid; die Sache hatte ihm leidgetan; das braucht dir nicht leidzutun; das wird dir noch leidtun! 
leidtragend	Leid tragend / leidtragend	leidtragend; die leidtragende Minderheit; die Kinder waren bei der Trennung die Leidtragenden 
letztere; -r; -s	Letztere; -r; -s	Letztere; -r; -s; von den Vorschlägen gefällt mir der Letztere am besten; Ersteres und Letzteres 
liegenbleiben	liegen bleiben	In wörtlicher Bedeutung liegen bleiben: Das Buch kann hier liegen blieben; als der Wecker klingelte, wollte er noch ein bisschen liegen bleiben  In übertragener Bedeutung liegen bleiben / liegenbleiben; was in der Garderobe nicht alles liegen bleibt / liegenbleibt (vergessen wird)!; der Lastwagen ist mit defektem Motor liegen geblieben / liegengeblieben 
liegenlassen	liegen lassen	In wörtlicher Bedeutung liegen lassen; der Gast hatte 2 Euro Trinkgeld auf dem Tisch liegen lassen; du musst das Buch hier liegen lassen!  In übertragener Bedeutung liegen lassen / liegenlassen; er hatte sein Portemonnaie an der Kasse liegen lassen / liegenlassen (vergessen); sie hatte ihn links liegen lassen / liegenlassen (seltener: links liegen gelassen / liegengelassen) 
linksstehend	links stehend	links stehend / linksstehend; eine extrem links stehende / linksstehende Gruppierung; aber: der auf dem Foto links stehende / linksstehende Mann; aber nur: linksgerichtet; linksorientiert 
Litfaßsäule	Litfaßsäule	Litfaßsäule (keine Änderung, da das Wort auf den Namen des Erfinders Ernst Litfaß zurückgeht) 
Love-Story	Lovestory	Lovestory; die Bekanntschaft entwickelte sich schnell zu einer Lovestory; aber: Shortstory / Short Story (Kurzgeschichte) 
Mammographie	Mammographie	Mammografie / Mammographie (Röntgenuntersuchung der weiblichen Brust); zur Früherkennung von Brustkrebs ist die Mammografie / Mammographie derzeit die Methode der Wahl 
Marathon laufen	Marathon laufen	Marathon laufen / marathonlaufen; letzten Sommer ist er viel Marathon gelaufen / marathongelaufen; aber nur: er läuft Marathon; einen Marathon laufen 
maschineschreiben; aber: ich schreibe Maschine	Maschine schreiben	Maschine schreiben; Sie hat den Brief Maschine geschrieben; aber: ein maschinengeschriebener / maschinegeschriebener Brief 
maßhalten	Maß halten	Maß halten / maßhalten; er hält nie Maß / maß; sie hatte zeit ihres Lebens Maß gehalten / maßgehalten; ein Maß haltender / maßhaltender Wunsch 
metallverarbeitend	Metall verarbeitend	Metall verarbeitend / metallverarbeitend; die Metall verarbeitende / metallverarbeitende Industrie 
Mikrophon / Mikrofon	Mikrofon / Mikrophon	Mikrofon / Mikrophon; der Ehrengast wurde ans Mikrofon / Mikrophon gebeten; entsprechend: Babyfon / Babyphon; Diktafon / Diktaphon; Megafon / Megaphon; aber nur noch: Telefon; telefonieren 
mit Hilfe	mithilfe / mit Hilfe	mithilfe / mit Hilfe; er konnte sich nur mithilfe / mit Hilfe von Krücken fortbewegen; mithilfe / mit Hilfe aller Freunde gelang die Renovierung schnell 
mitleiderregend	Mitleid erregend / mitleiderregend	Mitleid erregend / mitleiderregend; aber nur: ein größtes Mitleid erregender Fall; ein äußerst mitleiderregender Fall 
Mittwoch abend	Mittwochabend	Mittwochabend 
Mittwoch abends / mittwochs abends	mittwochabends / mittwochs abends	mittwochabends / mittwochs abends 
Montag abend	Montagabend	Montagabend 
Montag abends / montags abends	montagabends / montags abends	montagabends / montags abends 
Mop	Mopp	Mopp; um den Boden zu moppen, braucht man einen Mopp; aber: Mob (Pöbel); Mobbing; mobben (Schikane am Arbeitsplatz) 
morgen früh	morgen früh	morgen Früh / morgen früh; ich werde gleich morgen Früh / morgen früh damit anfangen; aber nur: morgen Vormittag; morgen Nachmittag; morgen Abend 
Multiple-choice-Verfahren	Multiplechoiceverfahren / Multiple-Choice-Verfahren	Multiple-Choice-Verfahren; Prüfungen nach dem Multiple-Choice-Verfahren 
nächste  	Nächste	Nächste; sich selbst der Nächste sein; das nehmen wir uns als Nächstes vor 
naheliegend (klar, plausibel)   nahe liegend (in der Nähe liegend)	nahe liegend	naheliegend (klar, plausibel); das ist ein naheliegender Gedanke  nahe liegend / naheliegend (in der Nähe liegend); die nahe liegende / naheliegende Ortschaft 
nahestehend (vertraut sein)   nahe stehend (in der Nähe stehend)	nahe stehend	nahestehend (vertraut sein); er lud alle ihm nahestehenden Menschen ein  nahe stehend / nahestehend (in der Nähe stehend); das nahe stehende / nahestehende Haus 
näherkommen (sich gegenseitig annähern)    näher kommen (einem Ziel)  	näher kommen	näherkommen (sich gegenseitig annähern); sie waren sich im Gespräch nähergekommen; entsprechend: nahekommen  näher kommen (einem Ziel); der Wind erlaubte es, der Küste schnell näher zu kommen; entsprechend: nahe kommen 
Negligé / Négligé	Negligee / Negligé	Negligee / Negligé / Négligé (leichter, eleganter Morgenmantel; leichtes Hauskleid) 
neunziger Jahre (Jahrzehnt)     Neunzigerjahre (Lebensabschnitt)	Neunzigerjahre / neunziger Jahre (Jahrzehnt)    Neunzigerjahre / neunziger Jahre (Lebensabschnitt)	Neunzigerjahre / neunziger Jahre (Jahrzehnt); in den Neunzigerjahren / neunziger Jahren des 20. Jahrhunderts; mit Ziffern: die 90er-Jahre / 90er Jahre; Kurzform: in den Neunzigern  Neunzigerjahre / neunziger Jahre (Lebensabschnitt); sie war schon weit in den Neunzigerjahren / neunziger Jahren; Kurzform: in den Neunzigern 
nichtsahnend	nichts ahnend	nichts ahnend / nichtsahnend; die nichts ahnenden / nichtsahnenden Eltern 
nichts anderes	nichts anderes	nichts anderes / nichts Anderes; nichts anderes / nichts Anderes habe ich damit gemeint! 
nichtssagend	nichts sagend	nichts sagend / nichtssagend; ein nichts sagendes / nichtssagendes Gesicht 
Nichtzutreffendes	Nichtzutreffendes / nicht Zutreffendes	Nichtzutreffendes / nicht Zutreffendes; Nichtzutreffendes / nicht Zutreffendes bitte streichen! 
noch mal	noch mal	nochmal / noch mal (= noch einmal); das Kind wollte nochmal / noch mal mit dem Karussell fahren; aber nur: noch einmal; nochmals (= ein weiteres Mal; erneut); er betonte seine Forderung nochmals 
No-future-Generation	No-Future-Generation / Nofuturegeneration	No-Future-Generation; er war ein typischer Vertreter der No-Future-Generation 
not tun	Not tun	nottun; die Renovierung hatte notgetan; Eile tut not! 
notleidend	Not leidend	Not leidend / notleidend; die Not leidenden / notleidenden Menschen in der Dritten Welt; aber nur: größte Not leidende Menschen; äußerst notleidende Menschen; notleidende Kredite (Bankwesen) 
Null (Nullpunkt)	null (Nullpunkt)  	null (Nullpunkt); Die Tachonadel steht auf null; die Stunde null; jetzt müssen wir wieder bei null anfangen; die Stimmung war unter null gesunken; er war in null Komma nichts zur Stelle; aber: er ist eine absolute Null! 
numerieren; Numerierung	nummerieren; Nummerierung	nummerieren; Nummerierung; im Theater gab es nummerierte Plätze 
Nummer Sicher	Nummer Sicher /  Nummer sicher	Nummer Sicher / Nummer sicher; sie ging in allem stets ganz auf Nummer Sicher / Nummer sicher 
obengenannt; aber: die weiter oben genannten Mitwirkenden	oben genannt	oben genannt / obengenannt; die oben genannten / obengenannten Mitwirkenden  Substantivierung: die oben Genannten / Obengenannten; aber: die weiter oben Genannten 
offenbleiben	offen bleiben	In wörtlicher Bedeutung offen bleiben: Das Fenster soll offen bleiben; aber: das offen gebliebene / offengebliebene Fenster.  In übertragener Bedeutung offenbleiben: Die Frage musste offenbleiben; offengebliebene Fragen. 
offenhalten	offen halten	In wörtlicher Bedeutung offen halten: Der Fluchtweg muss offen gehalten werden; aber: der offen gehaltene / offengehaltene Fluchtweg.  In übertragener Bedeutung offenhalten: Man muss sich alle Möglichkeiten offenhalten; die offengehaltene Möglichkeit. 
ohne weiteres  (österr. auch: ohneweiters)	ohne weiteres  (österr. auch: ohneweiters)	ohne weiteres / ohne Weiteres (österr. auch: ohneweiters); ein Umtausch ist ohne weiteres / ohne Weiteres möglich 
Orthographie	Orthografie / Orthographie	Orthografie / Orthographie; in der Orthografie / Orthographie (= Rechtschreibung) war er sehr bewandert; orthografische / orthographische Feinheiten 
Panther	Panter / Panther	Panter / Panther 
papierverarbeitend	Papier verarbeitend	Papier verarbeitend / papierverarbeitend; die Papier verarbeitende / papierverarbeitende Industrie 
Paragraph	Paragraf / Paragraph	Paragraf / Paragraph; nicht jeder kennt sich im Paragrafendschungel / Paragraphendschungel aus 
Paßstraße	Passstraße	Passstraße / Pass-Straße; da der Tunnel gesperrt war, mussten wir die Passstraße / Pass-Straße nehmen 
Personalcomputer	Personalcomputer / Personal Computer	Personal Computer; 1981 stellte IBM den ersten Personal Computer (PC) vor 
Phantasie	Fantasie / Phantasie	Fantasie / Phantasie; die Lektüre beflügelte ihre Fantasie / Phantasie; entsprechend:  fantasieren / phantasieren;  Fantasterei / Phantasterei;  fantastisch / phantastisch;  fantasievoll / phantasievoll 
planschen	planschen / plantschen	planschen / plantschen; im Sommer planschen / plantschen die Kinder gerne im Planschbecken / Plantschbecken; du planschst / plantschst ja nur rum! 
plan schleifen	plan schleifen	plan schleifen / planschleifen 
Platitüde / Platitude	Plattitüde / Platitude	Plattitüde / Platitude; er gab nur Plattitüden / Platituden  (= Plattheiten) von sich 
platt drücken	platt drücken	platt drücken / plattdrücken; sich die Nasen platt drücken / plattdrücken 
platzen lassen	platzen lassen	platzenlassen / platzen lassen (ein Geschäft)  platzen lassen (einen Luftballon) 
plazieren / placieren	platzieren / placieren	platzieren / placieren; die deutsche Fußballmannschaft platzierte / placierte sich unter den ersten zehn; der Boxer platzierte / placierte seinen Schlag direkt am Kinn des Gegners 
pleite gehen	Pleite gehen	pleitegehen; nach der Wirtschaftskrise war die Firma pleitegegangen; aber: Pleite machen; pleite sein 
Pornographie	Pornografie / Pornographie	Pornografie / Pornographie; der Grat zwischen Kunst und Pornografie / Pornographie ist oft schmal; pornografische / pornographische Aufnahmen 
Portemonnaie	Portemonnaie / Portmonee	Portemonnaie / Portmonee; im Gedränge war ihm sein Portemonnaie / Portmonee abhandengekommen 
potentiell	potenziell / potentiell	potenziell /  potentiell; ein potenzieller / potentieller Kunde; entsprechend: Potential / Potenzial 
probefahren	Probe fahren	Probe fahren; er verlangte, das Motorrad erst Probe zu fahren; er hatte den Sportwagen Probe gefahren 
publik machen	publik machen	publik machen / publikmachen; der Popstar war bekannt dafür, seine Affären gerne publik zu machen / publikzumachen; aber nur: publik werden 
Pußta	Puszta	Puszta; eine regionale Spezialität der Puszta ist die Pusztasalami 
Quentchen	Quäntchen	Quäntchen; ein kleines Quäntchen Glück braucht jedermann 
quergestreift	quer gestreift / quergestreift	quer gestreift / quergestreift; ein quer gestreiftes / quergestreiftes T-Shirt 
querlesen	quer lesen	querlesen (flüchtig lesen); er las die Zeitschrift quer; sie hatte das Lehrbuch nur quergelesen 
rauh	rau	rau; eine raue Oberfläche; raue Sitten; entsprechend: Raufasertapete; Rauhaardackel; Raubein 
radfahren	Rad fahren	Rad fahren; Auto fahren und Rad fahren; aber: Auf dem Gehweg ist das Radfahren verboten; der Rad fahrende / radfahrende Teil der Bevölkerung 
ratsuchend	Rat suchend	Rat suchend / ratsuchend; er wandte sich Rat suchend / ratsuchend an einen Freund; der Andrang der Rat Suchenden / Ratsuchenden war groß 
recht geben	Recht geben	Recht geben / recht geben; der Erfolg gibt uns Recht / recht! 
recht haben	Recht haben	Recht haben / recht haben; wo du Recht / recht hast, hast du Recht / recht; wie Recht / recht sie doch hatte!; entsprechend: Recht bekommen / recht bekommen 
rechtsstehend	rechts stehend	rechts stehend / rechtsstehend; eine extrem rechts stehende / rechtsstehende Gruppierung; aber: der auf dem Foto rechts stehende / rechtsstehende Mann; aber nur: rechtsgerichtet; rechtsorientiert 
recyceln	recyceln	recyceln / recyclen; unsere Abfälle werden recycelt / recyclet; ich nutze nur recyceltes / recycletes Papier; diese Verpackung ist recycelbar / recyclebar 
rekeln / räkeln	rekeln / räkeln	rekeln / räkeln; sie rekelte / räkelte sich behaglich auf der Couch (keine Empfehlung, da regional je nach Aussprache unterschiedliche Handhabung; die ältere Form ist rekeln) 
respekteinflößend	Respekt einflößend	Respekt einflößend / respekteinflößend; eine Respekt einflößende / respekteinflößende Persönlichkeit; aber nur: großen Respekt einflößend; äußerst respekteinflößend; entsprechend: Respekt heischend / respektheischend 
richtigstellen (eine falsche Behauptung)    richtig stellen (eine Uhr; einen Schrank)	richtig stellen	richtigstellen (eine falsche Behauptung); das war ein Missverständnis, lassen Sie mich das richtigstellen!  richtig stellen / richtigstellen (eine Uhr; einen Schrank); richtig gestellte / richtiggestellte Uhren schützen vor Unpünktlichkeit 
Round table	Roundtable /  Round Table	Round Table; eine Round-Table-Konferenz; ein Round-Table-Gespräch; aber: ein Gespräch am runden Tisch 
rundmachen	rund machen	in wörtlicher Bedeutung rund machen / rundmachen; mit heißem Wasser kann man einen eingedrückten Tischtennisball wieder rund machen / rundmachen  in übertragener Bedeutung rundmachen; 1. tadeln, maßregeln: der Chef hat den neuen Angestellten rundgemacht; 2. optimieren, den letzten Schliff geben: wir müssen das Konzept noch rundmachen 
Samstag abend	Samstagabend	Samstagabend 
Samstag abends / samstags abends	samstagabends / samstags abends	samstagabends / samstags abends 
Sauerstoffflasche	Sauerstoffflasche	Sauerstoffflasche / Sauerstoff-Flasche; längeres Tauchen ist nur mit einer Sauerstoffflasche / Sauerstoff-Flasche möglich; entspr.: Kunststoffflasche / Kunststoff-Flasche 
scharfmachen (aufhetzen; anstacheln)    scharf machen (schärfen)	scharfmachen (aufhetzen; anstacheln)    scharf machen (schärfen)	scharfmachen (aufhetzen; anstacheln); einen Hund scharfmachen; sie hatte ihn ganz schön scharfgemacht (= sexuell angeregt)  scharf machen / scharfmachen (schärfen); die Bombe scharf machen / scharfmachen; die Currywurst scharf machen / scharfmachen 
schlechtmachen (herabsetzen)   schlecht machen (schlecht ausführen)	schlecht machen	schlechtmachen (herabsetzen); sie hatte ihn in der ganzen Stadt schlechtgemacht  schlecht machen (schlecht ausführen); die Filmkulissen waren schlecht gemacht und wirkten künstlich 
schneuzen	schnäuzen	schnäuzen; während der Vorstellung mussten sich viele vernehmlich schnäuzen; du schnäuzt dich aber oft, bist du erkältet? 
Schwarzer Peter	schwarzer Peter	schwarzer Peter / Schwarzer Peter (Kartenspiel); gestern haben wir den ganzen Nachmittag schwarzer Peter / Schwarzer Peter gespielt; aber nur: jemandem den schwarzen Peter zuschieben / zuspielen (= die Verantwortung abwälzen) 
schwerbehindert	schwer behindert	schwer behindert / schwerbehindert; aber nur: sehr schwer behindert; schwerer behindert; am schwersten behindert; schwerstbehindert; Schwerbehinderte 
schwerbewaffnet	schwer bewaffnet	schwer bewaffnet / schwerbewaffnet; die schwer bewaffneten / schwerbewaffneten Terroristen; aber nur: sie waren schwer bewaffnet 
schwerkrank	schwer krank	schwer krank / schwerkrank; sie ist eine schwer kranke / schwerkranke Frau; aber nur: der Patient ist schwer krank; der/die Schwerkranke 
schwertun	schwer tun	schwertun; er hatte sich mit den Änderungen schwergetan; wenn du dich mit der Hausarbeit nur nicht so schwertätest!; entsprechend: das darfst du nicht so schwernehmen!; aber: man sollte sich das Leben nicht unnötig schwer machen / schwermachen; aber nur: das wird sich schwer machen lassen 
schwerwiegend	schwer wiegend	schwer wiegend / schwerwiegend; ein schwer wiegender / schwerwiegender Verdacht; schwerer wiegende / schwerwiegendere Einwände; das am schwersten wiegende / schwerwiegendste Argument 
Science-fiction	Sciencefiction	Science-Fiction / Sciencefiction; er sieht sich gerne Science-Fiction-Filme / Sciencefiction-Filme / Sciencefictionfilme an 
seinlassen (unterlassen)	sein lassen (unterlassen)	sein lassen / seinlassen (unterlassen); er beschloss, das Trinken sein zu lassen / seinzulassen; kannst du das Rauchen nicht sein lassen / seinlassen? 
seit langem	seit langem	seit langem / seit Langem; seit längerem / seit Längerem; er ist schon seit längerem / seit Längerem Nichtraucher; entsprechend: seit kurzem / seit Kurzem 
seit neuestem	seit neuestem	seit neuestem / seit Neuestem; seit neuestem / seit Neuestem fährt hier auch die U-Bahn 
selbständig   Selbständigkeit	selbstständig / selbständig   Selbstständigkeit / Selbständigkeit	selbstständig /  selbständig  Selbstständigkeit / Selbständigkeit 
siebziger Jahre (Jahrzehnt)     Siebzigerjahre (Lebensabschnitt)	Siebzigerjahre / siebziger Jahre (Jahrzehnt)     Siebzigerjahre / siebziger Jahre (Lebensabschnitt)	Siebzigerjahre / siebziger Jahre (Jahrzehnt); die schrillen Siebzigerjahre / siebziger Jahre; mit Ziffern: die 70er-Jahre / 70er Jahre; Kurzform: in den Siebzigern  Siebzigerjahre / siebziger Jahre (Lebensabschnitt); sie war schon weit in den Siebzigerjahren / siebziger Jahren; Kurzform: in den Siebzigern 
selbstgemacht	selbst gemacht	selbst gemacht / selbstgemacht; sie schenkte ihm ein Glas ihrer selbst gemachten / selbstgemachten Marmelade; aber nur: sie hat die Marmelade selbst gemacht; entsprechend: ein selbst gebackener / selbstgebackener Kuchen; ein selbst geschriebener / selbstgeschriebener Brief; ein selbst gestrickter / selbstgestrickter Pullover; das erste selbst verdiente / selbstverdiente Geld 
sitzen bleiben (auf seinem Platz)  sitzenbleiben (in der Schule)	sitzen bleiben (auf seinem Platz)  sitzen bleiben (in der Schule)	sitzen bleiben (auf seinem Platz)  sitzen bleiben / sitzenbleiben (in der Schule) 
so daß	sodass / so dass	sodass / so dass; die Busse hatten Verspätung, sodass / so dass viele zu spät zur Arbeit kamen 
sogenannt	so genannt	so genannt / sogenannt; aber nur: die fälschlich so genannten ... 
soviel	so viel	so viel; er nahm so viel, wie er tragen konnte; so viel dazu!; aber: zum sovielten Mal, das sovielte Mal; soviel er auch spart, nie ist Geld da; soviel ich weiß, ist sie verreist 
Sonntag abend	Sonntagabend	Sonntagabend 
Sonntag abends / sonntags abends	sonntagabends / sonntags abends	sonntagabends / sonntags abends 
soweit	so weit	so weit; so weit das Auge reicht; so weit, so gut!; aber: soweit ich weiß, ist sie verreist; soweit ich das beurteilen kann, ist das eine gute Arbeit 
Spaghetti	Spaghetti / Spagetti	Spaghetti / Spagetti; Spaghetti / Spagetti bolognese schmecken al dente am besten 
spitze (das ist spitze!)	Spitze (das ist spitze!)	spitze (das ist spitze!); ein spitze Vorschlag; das Konzert war spitze; aber: das ist einsame Spitze 
sprechen lassen	sprechen lassen	(Blumen) sprechen lassen / sprechenlassen 
Stengel	Stängel	Stängel; die Pflanze hatte einen langen Stängel; eine langstängelige Pflanze 
Stenographie	Stenografie / Stenographie	Stenografie / Stenographie; mit Kurzschriftsystemen wie der Stenografie / Stenographie können hohe Schreibgeschwindigkeiten erreicht werden; entsprechend: Demografie / Demographie 
Stilleben	Stillleben	Stillleben / Still-Leben; das holländische Stillleben / Still-Leben stammte aus dem  17. Jahrhundert 
strenggenommen	streng genommen	streng genommen / strenggenommen; ein sehr streng genommenes / strenggenommenes Reglement; aber nur: streng genommen[,] stimmt das 
Telegrafie / Telegraphie	Telegrafie / Telegraphie	Telegrafie / Telegraphie; die elektrische Telegrafie / Telegraphie wurde 1833 erfunden; aber nur noch: Telefonie; Telefon 
Tête-à-tête	Tête-à-Tête /  Tete-a-Tete	Tête-à-tête / Tete-a-tete; sie trafen sich zum Tête-à-tête / Tete-a-tete (zum vertraulichen Zusammensein); aber: sie besprachen sich tête-à-tête  (= unter vier Augen) 
Thunfisch	Tunfisch / Thunfisch	Tunfisch / Thunfisch; der biologische Oberbegriff für Tunfische / Thunfische lautet Thunnus 
Tip	Tipp	Tipp; einen heißen Tipp bekommen; Geheimtipp; Börsentipp; Insidertipp 
todblaß	todblass	todblass; als er die Nachricht erhielt, wurde er todblass; aber: totenblass 
Tolpatsch	Tollpatsch	Tollpatsch; sie stellte sich in allem sehr tollpatschig an 
Tomographie	Tomographie	Tomographie / Tomografie; der Begriff der Tomographie / Tomografie fasst verschiedene bildgebende Verfahren zusammen; entsprechend: Computertomographie / Computertomografie; Elektrokardiographie / Elektrokardiografie; Kymographie / Kymografie; Organographie / Organografie; Polygraphie / Polygrafie; Radiographie / Radiografie; Röntgenographie / Röntgenografie; Sonographie / Sonografie 
tieferlegen; tiefergelegt	tiefer legen; tiefer gelegt	tieferlegen; tiefergelegt: ein tiefergelegter Sportwagen 
tiefgehend	tief gehend	tief gehend / tiefgehend; eine tief gehende / tiefgehende Analyse 
tiefgreifend	tief greifend	tief greifend / tiefgreifend; ein tief greifender / tiefgreifender Einschnitt 
Tonic water	Tonicwater	Tonicwater (kurz: Tonic); als Marke der Firma Schweppes auch: Tonic Water 
Trekking	Trekking	Trekking / Trecking; sie planten eine mehrtägige Trekkingtour / Treckingtour 
trockenwischen (mit Wischen trocknen)  trocken wischen (mit einem trockenen Tuch wischen)	trocken wischen   trocken wischen	trocken wischen / trockenwischen (mit Wischen trocknen)  trocken wischen  (mit einem trockenen Tuch wischen) 
übelnehmen	übel nehmen	übel nehmen / übelnehmen; das nehme ich dir übel; sie konnte ihm nichts übel nehmen / übelnehmen; ich bitte, das nicht übel zu nehmen / übelzunehmen 
übelriechend	übel riechend	übel riechend / übelriechend; die übel riechenden / übelriechenden Abfälle im Hof; das übel Riechende / Übelriechende beseitigen 
übelwollen	übel wollen	übelwollen; Menschen, die uns übelwollen, übelwollende Menschen 
überhandnehmen	überhand nehmen	überhandnehmen; die Störungen nehmen überhand; die Spam-Mails drohen überhandzunehmen 
überschwenglich	überschwänglich	überschwänglich; die Gäste wurden mit überschwänglicher Freude empfangen 
um so	umso	umso; das ist umso besser! 
unselbständig   Unselbständigkeit	unselbstständig / selbständig  Unselbstständigkeit / Unselbständigkeit	unselbstständig /  unselbständig  Unselbstständigkeit / Unselbständigkeit 
untenliegend	unten liegend	unten liegend / untenliegend; ein Motor mit unten liegender / untenliegender Nockenwelle; das unten Liegende / Untenliegende zuoberst kehren 
untenstehend	unten stehend	unten stehend / untenstehend; bitte die unten stehenden / untenstehenden Anmerkungen beachten; das unten Stehende / Untenstehende beachten 
unterderhand	unter der Hand	unter der Hand; da lässt sich unter der Hand (im Geheimen) sicher etwas machen 
verloren geben	verloren geben	verloren geben / verlorengeben; sie hatten das Turnier frühzeitig verloren gegeben / verlorengegeben (= die Hoffnung auf einen Sieg aufgegeben) 
verlorengehen	verloren gehen	verloren gehen / verlorengehen; der Ausweis darf nicht verloren gehen / verlorengehen; der verloren gegangene / verlorengegangene Ausweis; aber nur: Verlorengegangenes; und nur: verschüttgehen (Umgangssprache) 
vermissen lassen	vermissen lassen	vermissen lassen / vermissenlassen; jegliches Feingefühl vermissen lassen / vermissenlassen 
verselbständigen	verselbstständigen / verselbständigen	verselbstständigen / verselbständigen; die Dinge haben sich verselbstständigt / verselbständigt 
vielsagend	viel sagend	viel sagend / vielsagend; ein viel sagender / vielsagender Hinweis; sein Blick war viel sagend / vielsagend 
vielversprechend	viel versprechend	viel versprechend / vielversprechend; ein viel versprechendes / vielversprechendes Talent 
vielzitiert	viel zitiert	viel zitiert / vielzitiert; ein viel zitierter / vielzitierter Denker; eine viel zitierte / vielzitierte Politikerin 
vis-à-vis	vis-a-vis / vis-à-vis	vis-a-vis / vis-à-vis (gegenüber); das Hotel liegt vis-a-vis / vis-à-vis dem Hauptbahnhof, aber: das Visavis (das Gegenüber) 
vollaufen	voll laufen	volllaufen; er hatte sich in der Kneipe volllaufen lassen; die Wanne ist vollgelaufen 
von neuem	von neuem	von neuem / von Neuem; sie versuchten es von neuem / von Neuem; jetzt müssen wir ganz von neuem / von Neuem anfangen! 
von seiten	vonseiten / von Seiten	vonseiten / von Seiten; es gab Einwände vonseiten / von Seiten der Opposition 
vonstatten gehen	vonstatten gehen	vonstattengehen; die Arbeiten am Haus gingen sehr rasch vonstatten; er kritisierte, wie das Projekt vonstattengegangen war 
von weitem	von weitem	von weitem / von Weitem; er sah sie schon von weitem / von Weitem kommen; entsprechend: von nahem / von Nahem 
vorgestern nacht	vorgestern Nacht	vorgestern Nacht; seit vorgestern Nacht haben wir wieder Winterzeit; aber: vorgestern früh / vorgestern Früh 
vor kurzem	vor kurzem	vor kurzem / vor Kurzem; sie sind erst vor kurzem / vor Kurzem in diese Stadt gezogen; entsprechend: seit kurzem / seit Kurzem; binnen kurzem / binnen Kurzem 
vorliebnehmen	vorlieb nehmen	vorliebnehmen; mit einem Gebrauchtwagen vorliebnehmen; der Verkäufer bat, mit einem Gutschein vorliebzunehmen 
Waggon	Waggon / Wagon	Waggon / Wagon (Eisenbahnwagen) 
wahr machen	wahr machen	wahr machen / wahrmachen; er plante, die Drohung wahr zu machen / wahrzumachen 
warmlaufen; den Motor warmlaufen lassen  warm laufen; sich (beim Sport) warm laufen	warm laufen; den Motor warm laufen lassen; sich (beim Sport) warm laufen	warm laufen; den Motor warm laufen lassen; sich beim Sport warm laufen  warmlaufen; sich im Gespräch warmlaufen (= eingewöhnen) 
Wächte	Wechte	Wechte (Schneeanwehung; überhängende Schneemassen im Gebirge); die Wechte drohte abzubrechen und eine Lawine auszulösen 
weh tun	wehtun	wehtun / weh tun; hast du dir wehgetan / weh getan? 
weitreichend	weit reichend	weit reichend / weitreichend; weit reichende / weitreichende Änderungen; weiter reichende oder weitreichendere Änderungen, am weitesten reichende oder weitreichendste Änderungen 
wichtig machen	wichtig machen	wichtigmachen; er neigte dazu, sich wichtigzumachen 
wiederfinden	wieder finden	wiederfinden; er hatte das Portemonnaie unter dem Bett wiedergefunden; sie fand sich in einer bunten Menge wieder; in dir kann ich mich wiederfinden! 
wiedersehen (ein Wiedersehen erleben)   wieder sehen (erneut sehen)	wieder sehen	wiedersehen (ein Wiedersehen erleben); er freute sich, sie wiederzusehen  wieder sehen (erneut sehen); den Film habe ich schon dreimal gesehen, erst letzte Woche habe ich ihn wieder gesehen 
wiederverwendbar	wieder verwendbar	wiederverwendbar; diese Senfgläser sind als Saftgläser wiederverwendbar; aber: nachdem er den Computer repariert hatte, war dieser wieder verwendbar 
wieviel; aber: wie viele	wie viel	wie viel; weißt du, wie viel Sternlein stehen?; aber: ich weiß nicht, wievielmal (auch: wie viel Mal) ich schon am Meer gewesen bin; zu wievielt (auch: zu wie vielen) wart ihr? 
wohlbekannt	wohl bekannt	wohl bekannt / wohlbekannt; ein wohl bekanntes / wohlbekanntes (= gut bekanntes) Kirchenlied; aber: ein wohl (= vermutlich) bekanntes Problem 
wohldurchdacht	wohl durchdacht	wohl durchdacht / wohldurchdacht; ein wohl durchdachter / wohldurchdachter Plan 
wohl fühlen	wohl fühlen	wohl fühlen / wohlfühlen; ich habe mich bei euch sehr wohl gefühlt / wohlgefühlt 
wohlverdient	wohlverdient	wohlverdient; ein wohlverdienter Urlaub (hier gab es nie eine Änderung!) 
wohlversorgt	wohl versorgt	wohl versorgt / wohlversorgt; durch die Rente waren sie wohl versorgt / wohlversorgt; aber nur: mit der Abfindung bist du wohl (vermutlich) versorgt 
x-beliebig; jeder x-beliebige	x-beliebig;  jeder x-Beliebige	x-beliebig; jeder x-Beliebige 
x-te; zum x-tenmal; aber: zum x-ten Male	x-te; zum x-ten Mal[e]	x-te;  zum x-ten Mal[e];  die x-te Wiederholung; das habe ich dir jetzt schon zum x-ten Mal gesagt! 
Xerographie	Xerografie / Xerographie	Xerografie / Xerographie (ein Vervielfältigungsverfahren) 
Xylophon	Xylofon / Xylophon	Xylofon / Xylophon (ein Musikinstrument, bei dem Holzstäbe mit Holzklöppeln angeschlagen werden); entsprechend: Saxofon / Saxophon; Sousafon / Sousaphon (Basstuba); Vibrafon / Vibraphon; aber: Grammofon / Grammophon 
Yacht / Jacht	Yacht / Jacht	Yacht / Jacht; nachts liegen die Yachten / Jachten im Yachthafen / Jachthafen 
Yankee-doodle	Yankee Doodle	Yankee Doodle (bekanntes amerikanisches Lied; offizielle Hymne von Connecticut) 
Yellow Press	Yellowpress / Yellow Press	Yellow Press; man darf nicht alles glauben, was in der Yellow Press (= Klatschpresse) steht 
Yo-Yo / Jo-Jo	Yo-Yo / Jo-Jo	Yo-Yo / Jo-Jo; sie spielte gerne mit ihrem Yo-Yo / Jo-Jo; aber nur: der Jo-Jo-Effekt 
Yoghurt	Yoghurt	Yoghurt vgl. --> Joghurt / Jogurt 
Zäheit	Zähheit	Zähheit; sie zeichnete sich durch viel Ausdauer und Zähheit aus 
zeitraubend	zeitraubend	Zeit raubend / zeitraubend; aber nur: ein äußerst zeitraubendes Prozedere, das zeitraubendste Verfahren; ein viel Zeit raubender Vorgang; entsprechend: Zeit sparend / zeitsparend 
Zierat	Zierrat	Zierrat; die Schatulle war mit allerlei Zierrat versehen 
zigtausend    Zigtausende	zigtausend / Zigtausend    Zigtausende / zigtausende	zigtausend / Zigtausend; es sind zigtausend / Zigtausend Sterne am Himmel  Zigtausende / zigtausende; es waren Zigtausende / zigtausende von Menschen auf der Veranstaltung 
zu eigen	zu Eigen	zu eigen; er machte sich die Theorien des Kollegen zu eigen; ich gebe dir dieses Buch zu eigen; aber: etwas sein Eigen nennen 
zufriedengeben	zufrieden geben	zufriedengeben; es entsprach seiner Art, sich mit wenig zufriedenzugeben; sie hatte sich mit einer Abfindung zufriedengegeben 
zufriedenstellen	zufrieden stellen	zufrieden stellen / zufriedenstellen; sie war leicht zufrieden zu stellen / zufriedenzustellen; das ist ein rundum zufrieden stellendes / zufriedenstellendes Ergebnis; aber nur: das Ergebnis war zufriedenstellender als letztes Jahr 
zugrunde	zugrunde / zu Grunde	zugrunde / zu Grunde; die Firma ging in den neunziger Jahren zugrunde / zu Grunde; der Hausbau drohte ihn zugrunde / zu Grunde zu richten 
zugrundeliegend	zugrunde liegend / zu Grunde liegend	zugrunde liegend / zu Grunde liegend / zugrundeliegend; das zugrunde liegende / zu Grunde liegende / zugrundeliegende Prinzip; aber: hier scheint ein anderes Prinzip zugrunde zu liegen / zu Grunde zu liegen 
zugunsten	zu Gunsten	zu Gunsten / zugunsten; der Richter entschied zu Gunsten / zugunsten des Angeklagten 
zugute halten	zugute halten	zugutehalten; er hielt sich einiges auf seine gewählte Ausdrucksweise zugute; dem Angeklagten wurde sein umfassendes Geständnis zugutegehalten; dem Angeklagten ist sein umfassendes Geständnis zugutezuhalten 
zugute kommen	zugute kommen	zugutekommen; er will sein Vermögen den Armen zugutekommen lassen 
zu Haus / zu Hause; österr. und schweiz. auch: zuhause	zu Haus / zu Hause; österr. und schweiz. auch: zuhause	zu Haus / zu Hause / zuhause; aber: das Zuhause. In unserem neuen Zuhause fühlen wir uns ganz zu Haus / zu Hause / zuhause. 
zu Lasten	zulasten / zu Lasten	zulasten / zu Lasten; der technische Fortschritt darf nicht zulasten / zu Lasten der Umwelt gehen 
zunichte machen	zunichte machen	zunichtemachen; der Sturm hatte die Ernte auf einen Schlag zunichtegemacht 
zunutze	zu Nutze / zunutze	zu Nutze / zunutze; die Erfindung macht sich neue wissenschaftliche Erkenntnisse zu Nutze / zunutze 
zupaß kommen /  zupasse kommen	zupass kommen / zupasse kommen	zupasskommen / zupassekommen; die Erbschaft kam ihm gerade zupass / zupasse; das Wetter ist uns sehr zupassgekommen / zupassegekommen 
zu Rate	zurate / zu Rate	zurate / zu Rate; er musste einen Fachmann zurate / zu Rate ziehen; er ging mit sich zurate / zu Rate (dachte gründlich nach); sie saßen zurate / zu Rate (beratschlagten sich) 
zurzeit / zur Zeit (jetzt; im Augenblick)   zur Zeit (zu einer näher bestimmten Zeit)	zurzeit (jetzt; im Augenblick)   zur Zeit (zu einer näher bestimmten Zeit)	zurzeit (jetzt; im Augenblick); zurzeit lebt sie im Ausland  zur Zeit (zu einer näher bestimmten Zeit); zur Zeit Bismarcks, zur Zeit der Ernte 
zusammensein	zusammen sein	zusammen sein; sie waren drei Jahre zusammen gewesen; es macht Spaß, mit euch zusammen zu sein 
zusein	zu sein	zu sein; als wir kamen, war der Supermarkt schon zu gewesen; er war total zu (= berauscht; betrunken) gewesen 
zu seiten	zuseiten / zu Seiten	zuseiten / zu Seiten (= auf beiden Seiten); zuseiten / zu Seiten des Bahndamms gab es viel Wildwuchs 
zustande	zustande / zu Stande	zustande / zu Stande; der zustande / zu Stande gekommene Beschluss; eindrucksvoll, was manche einer alleine zustande / zu Stande bringt! 
zutage	zutage / zu Tage	zutage / zu Tage; der Prozess brachte unangenehme Wahrheiten zutage / zu Tage; erstaunlich, was da zutage / zu Tage kommt! 
zuteil werden	zuteil werden	zuteilwerden; ihr wurde viel Glück zuteil; ihm ist ein hartes Los zuteilgeworden 
zuungunsten	zu Ungunsten	zu Ungunsten / zuungunsten; eine Firmenentscheidung zu Ungunsten / zuungunsten der Aktionäre 
